30
22
1,1,1,1,1,1,1,1,1,1,1,1,1,1,1,1,1,1,1,1,1,1,1,1,1,1,1,1,1,1,
1,1,1,1,1,1,1,1,1,1,1,1,1,1,1,1,1,1,1,1,1,1,1,1,1,1,1,1,1,1,
1,1,1,1,1,1,1,1,1,1,4,1,1,1,1,1,1,1,1,1,1,1,1,1,1,1,1,1,1,1,
1,1,1,1,1,1,1,1,1,1,1,1,1,1,1,1,1,1,1,1,1,1,1,1,1,1,1,1,1,1,
1,1,1,1,1,1,1,1,1,1,1,1,1,1,1,1,1,1,1,1,1,1,1,1,1,1,1,1,1,1,
1,1,1,1,1,1,1,1,1,1,1,1,1,1,1,1,1,1,1,1,1,1,1,1,1,1,1,1,1,1,
1,1,1,1,3,3,3,3,1,1,1,1,1,1,1,1,1,1,1,1,1,1,1,1,1,1,1,1,1,1,
1,1,1,1,1,1,1,1,1,1,1,1,1,1,1,1,1,1,1,1,1,1,1,1,1,1,1,1,1,1,
1,1,1,1,1,1,1,1,1,1,1,1,1,1,1,1,1,1,1,1,1,1,1,1,1,1,1,1,1,1,
1,1,1,1,1,1,1,1,1,1,1,1,1,1,1,1,1,1,1,1,1,1,1,1,1,1,1,1,1,1,
1,1,1,1,1,1,1,1,1,1,1,1,1,1,1,1,1,1,1,1,1,1,1,1,1,1,1,1,1,1,
1,1,1,1,1,1,1,1,1,1,1,1,1,1,1,1,1,1,1,1,1,1,1,1,1,1,1,1,1,1,
1,1,1,1,1,1,1,1,1,1,1,1,1,1,1,1,1,1,1,1,1,1,1,1,1,1,1,1,1,1,
1,1,1,1,1,1,1,1,1,1,1,1,1,1,1,1,1,1,1,1,3,1,1,1,1,1,1,1,1,1,
1,1,1,1,1,1,1,1,1,1,1,1,1,1,1,1,1,1,1,1,3,1,1,1,1,1,1,1,1,1,
1,1,1,1,1,1,1,1,3,3,3,3,3,1,1,1,1,1,1,1,3,1,1,1,1,1,1,1,1,1,
1,1,1,1,1,1,1,1,1,1,1,1,1,1,1,1,1,1,1,1,3,1,1,1,1,1,1,1,1,1,
1,1,1,1,1,1,1,1,3,1,1,1,1,1,3,3,3,1,1,3,1,1,1,1,1,1,1,1,1,1,
1,1,1,1,1,1,1,1,1,1,1,1,1,3,1,1,1,3,1,3,1,1,1,1,1,1,1,1,1,1,
1,1,1,3,1,1,1,1,1,1,3,3,3,1,1,1,1,3,3,3,1,1,1,1,1,1,1,1,1,1,
1,1,1,1,3,3,3,3,3,3,1,1,1,1,1,1,1,1,1,1,1,1,1,1,1,1,1,1,1,1,
1,1,1,1,1,1,1,1,1,1,1,1,1,1,1,1,1,1,1,1,1,1,1,1,1,1,1,1,1,1,


























4,4,4,4,4,4,4,4,4,4,4,4,4,4,4,4,4,4,4,4,4,4,4,4,4,4,4,4,4,4,4,4,4,4,4,4,4,4,4,4,4,4,4,4,4,4,4,4,4,4,
4,4,4,4,4,4,4,4,4,4,4,4,4,4,4,4,4,4,4,4,4,4,4,4,4,4,4,4,4,4,4,4,4,4,4,4,4,4,4,4,4,4,4,4,4,4,4,4,4,4,
4,4,4,4,4,4,4,4,4,4,4,4,4,4,4,4,4,4,4,4,4,4,4,4,4,4,4,4,4,4,4,4,4,4,4,4,4,4,4,4,4,4,4,4,4,4,4,4,4,4,
4,4,4,4,4,4,4,4,4,4,4,4,4,4,4,4,4,4,4,4,4,4,4,4,4,4,4,4,4,4,4,4,4,4,4,4,4,4,4,4,4,4,4,4,4,4,4,4,4,4,
4,4,4,4,4,4,4,4,4,4,4,4,4,4,4,4,4,4,4,4,4,4,4,4,4,4,4,4,4,4,4,4,4,4,4,4,4,4,4,4,4,4,4,4,4,4,4,4,4,4,
4,4,4,4,4,4,4,4,4,4,4,4,4,4,4,4,2,2,2,2,2,2,2,2,2,2,4,4,4,4,4,4,4,4,4,4,4,4,4,4,4,4,4,4,4,4,4,4,4,4,
4,4,4,4,4,4,4,4,4,4,4,4,4,2,2,2,2,2,2,2,2,2,2,2,2,2,2,2,2,2,2,4,4,4,4,4,4,4,4,4,4,4,4,4,4,4,4,4,4,4,
4,4,4,4,4,4,4,4,4,4,4,4,2,2,2,2,2,2,2,2,2,1,2,2,2,2,2,2,2,2,2,2,2,4,4,4,4,4,4,4,4,4,4,4,4,4,4,4,4,4,
4,4,4,4,4,4,4,4,4,4,4,2,2,2,2,2,3,3,3,3,3,3,3,3,3,2,2,2,2,2,2,2,2,2,2,4,4,4,4,4,4,4,4,4,4,4,4,4,4,4,
4,4,4,4,4,4,4,4,4,4,2,2,2,3,3,3,3,3,3,3,3,3,3,3,3,3,3,3,3,3,3,2,2,2,2,2,2,2,4,4,4,4,4,4,4,4,4,4,4,4,
4,4,4,4,4,4,4,4,2,2,2,2,3,3,3,3,3,3,3,3,3,3,3,3,3,3,3,3,3,3,3,3,3,3,2,2,2,2,2,4,4,4,4,4,4,4,4,4,4,4,
4,4,4,4,4,4,2,2,2,2,2,3,3,3,3,5,3,3,3,3,3,3,3,3,3,3,3,3,3,3,3,3,3,3,3,2,2,2,2,4,4,4,4,4,4,4,4,4,4,4,
4,4,4,4,4,4,2,2,2,2,2,3,3,3,3,5,5,3,3,3,1,1,3,3,3,3,3,3,3,3,3,3,3,3,3,3,2,2,2,2,4,4,4,4,4,4,4,4,4,4,
4,4,4,4,4,2,2,2,2,3,3,3,3,3,5,5,5,3,3,3,1,1,3,3,3,3,3,5,5,3,3,3,3,3,3,3,3,2,2,2,2,4,4,4,4,4,4,4,4,4,
4,4,4,4,2,2,2,2,3,3,3,3,3,5,5,5,3,3,3,3,3,3,3,5,3,3,5,5,5,3,3,3,3,3,3,3,3,3,2,2,2,4,4,4,4,4,4,4,4,4,
4,4,4,4,2,2,2,3,3,3,3,3,3,5,5,5,3,3,3,3,3,3,3,5,5,5,5,5,5,3,3,3,3,3,3,3,3,3,3,2,2,4,4,4,4,4,4,4,4,4,
4,4,4,4,2,2,2,3,3,3,3,3,3,5,5,3,3,3,3,3,5,5,5,5,5,5,5,5,5,5,5,5,5,3,3,3,3,3,3,2,2,4,4,4,4,4,4,4,4,4,
4,4,4,4,2,2,2,2,3,1,1,3,3,3,3,3,3,3,3,5,5,3,5,5,5,5,5,5,5,5,5,5,5,3,3,3,3,3,1,1,4,4,4,4,4,4,4,4,4,4,
4,4,4,4,2,2,2,2,1,1,1,3,3,3,3,3,3,3,3,3,3,3,5,5,5,5,5,5,3,3,3,3,3,3,3,3,3,1,1,4,1,1,4,4,4,4,4,4,4,4,
4,4,4,4,4,2,2,1,1,1,3,3,3,3,3,3,3,3,3,3,3,3,5,5,5,3,3,3,3,3,3,3,3,3,3,3,1,4,4,1,2,2,4,4,4,4,4,4,4,4,
4,4,4,4,4,4,4,1,1,2,2,2,3,3,5,3,3,3,3,3,3,3,5,5,3,3,3,3,3,3,3,3,3,3,3,1,4,1,1,2,2,2,4,4,4,4,4,4,4,4,
4,4,4,4,4,4,4,4,2,2,2,2,3,5,5,3,3,3,3,3,3,3,3,3,3,3,3,3,3,3,3,3,6,6,1,4,1,1,3,3,2,2,2,4,4,4,4,4,4,4,
4,4,4,4,4,4,4,4,4,2,2,2,3,5,5,5,3,3,3,3,3,3,3,3,3,3,3,3,3,3,3,3,6,3,4,4,3,3,3,3,2,2,2,2,4,4,4,4,4,4,
4,4,4,4,4,4,4,4,4,4,2,2,3,5,5,5,3,3,3,3,3,3,3,3,3,3,3,3,3,3,3,6,6,4,4,6,3,3,5,3,2,2,2,2,4,4,4,4,4,4,
4,4,4,4,4,4,4,4,4,4,2,2,3,5,5,5,3,3,3,3,3,3,3,3,3,3,5,5,3,3,3,3,4,4,6,6,6,3,5,5,3,2,2,2,2,4,4,4,4,4,
4,4,4,4,4,4,4,4,4,4,2,2,3,3,3,3,3,3,3,3,3,3,5,5,5,5,5,5,3,3,3,4,4,4,4,6,3,3,3,5,5,5,5,2,2,4,4,4,4,4,
4,4,4,4,4,4,4,4,4,4,2,2,2,3,3,3,3,3,3,5,5,5,5,5,5,5,5,3,3,3,3,4,4,4,4,3,3,3,3,5,5,5,5,2,2,4,4,4,4,4,
4,4,4,4,4,4,4,4,4,4,2,2,2,3,3,3,3,3,5,5,5,6,6,6,6,6,6,6,3,3,3,3,3,4,4,3,3,3,3,3,3,3,3,2,2,4,4,4,4,4,
4,4,4,4,4,4,4,4,4,2,2,2,2,3,3,3,3,5,5,5,6,6,1,1,1,1,1,3,3,3,5,5,3,3,4,3,3,3,3,3,3,3,3,2,2,4,4,4,4,4,
4,4,4,4,4,4,4,4,2,2,2,2,3,3,3,3,3,5,3,1,1,1,1,1,1,1,1,1,3,5,5,5,3,3,3,3,3,3,3,3,3,3,3,2,2,4,4,4,4,4,
4,4,4,4,4,4,4,4,2,2,2,2,3,3,3,3,5,5,3,1,1,1,1,1,1,1,1,1,5,5,5,3,3,3,3,3,5,5,5,3,3,3,3,2,2,4,4,4,4,4,
4,4,4,4,4,4,4,4,2,2,2,3,3,3,3,3,5,3,3,1,1,1,1,1,1,1,1,1,3,5,5,3,3,3,3,5,5,5,5,3,3,3,2,2,2,4,4,4,4,4,
4,4,4,4,4,4,4,4,2,2,2,3,3,3,3,3,5,3,3,1,1,1,1,6,6,6,1,3,5,5,3,3,3,3,5,5,5,5,5,3,3,3,2,2,2,4,4,4,4,4,
4,4,4,4,4,4,4,2,2,2,2,3,3,3,3,3,3,3,3,3,3,6,6,6,5,5,5,5,5,3,3,3,5,5,5,5,5,5,5,3,3,3,2,2,2,4,4,4,4,4,
4,4,4,4,4,4,4,2,2,2,3,3,5,5,3,3,3,3,3,3,6,6,3,3,5,5,3,3,3,3,3,5,5,5,5,5,5,5,5,3,3,3,2,2,4,4,4,4,4,4,
4,4,4,4,4,4,4,2,2,2,3,3,5,5,3,3,3,3,5,5,5,3,3,3,3,3,3,3,3,3,5,5,5,5,5,5,5,5,5,3,3,2,2,2,4,4,4,4,4,4,
4,4,4,4,4,4,4,2,2,2,3,3,5,5,5,3,3,3,3,3,3,3,3,3,3,3,3,3,3,3,5,5,5,5,5,5,5,5,3,3,2,2,2,2,4,4,4,4,4,4,
4,4,4,4,4,4,4,2,2,2,2,3,3,5,5,3,3,3,3,3,3,3,3,3,3,3,3,3,3,3,3,3,3,3,3,3,3,3,3,3,2,2,2,4,4,4,4,4,4,4,
4,4,4,4,4,4,4,2,2,2,2,3,3,5,5,3,3,3,3,3,3,3,3,3,3,3,3,3,2,2,2,2,2,2,2,2,3,3,2,2,2,2,4,4,4,4,4,4,4,4,
4,4,4,4,4,4,4,4,2,2,2,2,3,3,3,3,3,3,3,3,3,3,3,3,2,2,2,2,2,2,2,2,2,2,2,2,2,2,2,2,2,4,4,4,4,4,4,4,4,4,
4,4,4,4,4,4,4,4,4,2,2,2,2,3,3,3,3,3,3,3,3,3,2,2,2,2,2,2,2,4,4,4,4,2,2,2,2,2,2,4,4,4,4,4,4,4,4,4,4,4,
4,4,4,4,4,4,4,4,4,4,2,2,2,2,2,2,2,2,2,2,2,2,2,2,2,2,2,4,4,4,4,4,4,4,4,4,4,4,4,4,4,4,4,4,4,4,4,4,4,4,
4,4,4,4,4,4,4,4,4,4,4,2,2,2,2,2,2,2,2,2,2,2,2,2,2,4,4,4,4,4,4,4,4,4,4,4,4,4,4,4,4,4,4,4,4,4,4,4,4,4,
4,4,4,4,4,4,4,4,4,4,4,4,4,4,2,2,2,2,2,2,2,4,4,4,4,4,4,4,4,4,4,4,4,4,4,4,4,4,4,4,4,4,4,4,4,4,4,4,4,4,
4,4,4,4,4,4,4,4,4,4,4,4,4,4,4,4,4,4,4,4,4,4,4,4,4,4,4,4,4,4,4,4,4,4,4,4,4,4,4,4,4,4,4,4,4,4,4,4,4,4,
4,4,4,4,4,4,4,4,4,4,4,4,4,4,4,4,4,4,4,4,4,4,4,4,4,4,4,4,4,4,4,4,4,4,4,4,4,4,4,4,4,4,4,4,4,4,4,4,4,4,
4,4,4,4,4,4,4,4,4,4,4,4,4,4,4,4,4,4,4,4,4,4,4,4,4,4,4,4,4,4,4,4,4,4,4,4,4,4,4,4,4,4,4,4,4,4,4,4,4,4,
4,4,4,4,4,4,4,4,4,4,4,4,4,4,4,4,4,4,4,4,4,4,4,4,4,4,4,4,4,4,4,4,4,4,4,4,4,4,4,4,4,4,4,4,4,4,4,4,4,4,
4,4,4,4,4,4,4,4,4,4,4,4,4,4,4,4,4,4,4,4,4,4,4,4,4,4,4,4,4,4,4,4,4,4,4,4,4,4,4,4,4,4,4,4,4,4,4,4,4,4,
4,4,4,4,4,4,4,4,4,4,4,4,4,4,4,4,4,4,4,4,4,4,4,4,4,4,4,4,4,4,4,4,4,4,4,4,4,4,4,4,4,4,4,4,4,4,4,4,4,4